50:40
xxxxxxxxxxxxxxxxxxxxxxxxxxxxxxxxxxxxxxxxxxxxxxxxxx
x                  x         x                   x
x                  x         x                   x
x                  x         x      xxxxxx       x
x                  x         x      x    x       x
x                  x         x      xxxSxx       x
x   D              x         x                   x
x                  x         x                   x
xxxxxxxxxxxxxx     x         x                   x
x                  x         x                   x
x                  x         x                   x
x                  x         x                   x
x                  x         x                   x
x                            x                   x
x                            x                   x
x                                                x
x                  x                             x
x                  x                             x
x                  x         x                   x
x                  x         x                   x
x                  x         x                   x
xxxxxxxxxxxxxxxxxxxx         xxxxxxxxxxxxxxxxxxxxx
x                            x                   x
x   xxxxxxxxxxxxxxx          x                   x
x   x             x          x                   x
x   x             x                              x
x   x             x                              x
x   xxxxxxxxxxxxxxx                              x
x                                                x
x                                                x
x                                                x
x                                                x
x                                                x
x          x                 xxxxxx              x
x          x                 x                   x
x          x                 x                   x
x          x                 x                   x
x          x                 x                   x
x          x                 x                   x
xxxxxxxxxxxxxxxxxxxxxxxxxxxxxxxxxxxxxxxxxxxxxxxxxx
